Map_size: 12 13
# # # # # # # # # # # #
# . . . . # . . . . . #
# . # # . # . # # # # #
# . . # . # . # . . . #
# # . # . # . . . # . #
S . . # . # . . . # . #
# # # # . # # . . # . #
# . . . . # . . . # . #
# . # # # # . # # # . #
# . # . . . . # . . . #
# . # # # # . # . . . #
# . . . . . . # . # . #
# # # # # # # # F # # #
Portals: 0