# # # # # # # # # # # #
#         #           #
#   # #   #   # # # # #
#     #   #   #       #
# #   #   #       #   #
      #   #       #   #
# # # #   # #     #   #
#         #       #   #
#   # # # #   # # #   #
#   #         #       #
#   # # # #   #       #
#             #   #   #
# # # # # # # #   # # #